###########
#         #
# #########
#        E#
#########X#
#XXS# #XXX#
#X#####X###
#X#XXXXX# #
#X#X#######
#XXX# # # #
###########