###########
# # #     #
### # ### #
# #   #   #
####### ###
# # # # #S#
####### #X#
# # # # #E#
####### # #
# # # #   #
###########