###########
#S  # #   #
#X# # # # #
#X#   #E# #
#X#####X# #
#XXX#XXX# #
###X#X### #
# #X#X# # #
###X#X# # #
# #XXX#   #
###########