###########
# # #     #
# ### #####
# # #     #
# ####### #
#E# # # # #
#X####### #
#X# #   # #
#X### # # #
#S    #   #
###########