###########
# #       #
######### #
#   #     #
# # # #####
# # #     #
# # ##### #
# # #XXX# #
# # #X#X# #
# #  E#XXS#
###########