###########
#SXX# #XXE#
# #X###X# #
# #XXXXX# #
######### #
#       # #
# ####### #
#     # # #
##### ### #
# # #     #
###########