###########
#    S# # #
# ###X#####
#   #X# # #
### #X#####
#   #X# # #
# ###X#####
# #E#X# # #
###X#X#####
# #XXX# # #
###########