###########
#   # # # #
# # #######
# #S# # # #
# #X#######
# #E# # # #
# # #######
# # # # # #
# # # #####
# #   # # #
###########