###########
# # # #E  #
#######X# #
#      S# #
# ####### #
#   # # # #
### # # # #
# # # # # #
### # # # #
# #   #   #
###########