###########
# # #  EXX#
### # ###X#
# #   # #X#
#########X#
# # #XXXXX#
#####X#####
#   #XXXXX#
# # #####X#
# #SXXXXXX#
###########