###########
# #XXX#   #
###X#X### #
# #E#X#XXS#
### #X#X###
#   #XXX# #
###########
# # # # # #
###########
# # # # # #
###########