###########
# # # # # #
###########
# # # # # #
###########
# # # # # #
###########
#EXX#  SXX#
# #X#####X#
# #XXXXXXX#
###########