###########
#XXXXE    #
#X####### #
#S  #   # #
### # ### #
# # # #   #
##### # ###
# # # # # #
##### # ###
# # #   # #
###########