###########
# #S# #XXE#
###X###X# #
# #X#XXX# #
###X#X### #
#XXX#X#   #
#X###X# ###
#X#XXX# # #
#X#X### ###
#XXX#   # #
###########