###########
# # #S    #
#####X### #
# # #E# # #
##### ### #
# # # # # #
######### #
# # #     #
##### #####
# # #     #
###########