###########
# #   #   #
### # # # #
#   # # #E#
##### # #X#
#XXX# # #X#
#X#X# # #X#
#X#S  # #X#
#X#######X#
#XXXXXXXXX#
###########