###########
#XXX# # # #
#X#X#######
#S#E#     #
# ####### #
# #     # #
# # ### # #
#   # #   #
###########
# # # # # #
###########