###########
#EXX#     #
###X##### #
# #XXX# # #
#####X### #
# # #XXS  #
###########
# # # # # #
###########
# # # # # #
###########