###########
# # # # # #
###########
# # # # # #
###########
# # # # # #
###########
# # #EXXXX#
# ### ###X#
#     #SXX#
###########