INPUT:
###########
#    S# # #
# ### #####
#   # # # #
### # #####
#   # # # #
# ### #####
# #E# # # #
### # #####
# #   # # #
###########

EXPECTED SOLUTION:
###########
#    S# # #
# ###X#####
#   #X# # #
### #X#####
#   #X# # #
# ###X#####
# #E#X# # #
###X#X#####
# #XXX# # #
###########

OUTPUT:
To solve the given maze and provide a path from the starting point 'S' to the endpoint 'E', we will outline the path using coordinates where (x, y) indicates the position in the grid. The starting point 'S' is located at (1, 2) and the endpoint 'E' is located at (7, 2). 

Here's the layout with coordinates:

```
###########
# (0,0) (1,0) S(1, 2)(2,0) (3,0) (4,0) (5,0) (6,0) (7,0) (8,0) (9,0) (10,0) #
# (0,1)   (1,1)   (2,1) (3,1) # (4,1) (5,1) (6,1) # (8,1) (9,1) (10,1) #
# (0,2) # (1,2) # (2,2) # (3,2) (4,2) (5,2) # (6,2) (7,2) # (9,2) (10,2) #
# (0,3) # # # (1,3) (2,3) # (3,3) (4,3) # (5,3) # (7,3) (8,3) (9,3) #
# (0,4) # # # (1,4) (2,4) (3,4) (4,4) # (5,4) # (7,4) (8,4) (9,4) #
# (0,5) # # # (1,5) (2,5) (3,5) # (4,5) (5,5) (6,5) (7,5) (8,5) (9,5) #
# (0,6) # E(1,6) # (2,6) (3,6) # (4,6) (5,6) # (7,6) (8,6) (9,6) (10,6) #
# (0,7) # # # (1,7) (2,7) # (3,7) (4,7) (5,7) # (7,7) # (9,7) (10,7) #
# (0,8) # # # (1,8) (2,8) (3,8) (4,8) # (5,8) # (7,8) (8,8) (9,8) #
# (0,9) ########### 
# (0,10)###########
```

The path from 'S' to 'E' can be represented as follows:

1. Start at **(1, 2)**
2. Move down to **(2, 2)**
3. Move down to **(3, 2)**
4. Move down to **(4, 2)**
5. Move down to **(5, 2)**
6. Move down to **(6, 2)**
7. Move down to **(7, 2)** (which is the 'E')

Here's the simplified version of the path:

- From S (1, 2) → (2, 2) → (3, 2) → (4, 2) → (5, 2) → (6, 2) → E (7, 2)

This path effectively goes directly downward through the middle of the maze. 

So, the path from S to E is: 
- (1, 2) → (2, 2) → (3, 2) → (4, 2) → (5, 2) → (6, 2) → (7, 2)

HUMAN VERIFICATION: