INPUT:
###########
#E  #     #
### ##### #
# #   # # #
##### ### #
# # #  S  #
###########
# # # # # #
###########
# # # # # #
###########

EXPECTED SOLUTION:
###########
#EXX#     #
###X##### #
# #XXX# # #
#####X### #
# # #XXS  #
###########
# # # # # #
###########
# # # # # #
###########

OUTPUT:
To navigate from the start point (S) to the exit point (E) in the maze you've provided, we will outline a possible path through the available openings. Here's the maze again for reference and the solution path indicated:

```
###########
#E  #     #
### ##### #
# #   # # #
##### ### #
# # #  S  #
###########
# # # # # #
###########
# # # # # #
###########
```

We'll make our way from S to E step-by-step:

1. Start at S (located at (5, 7)).
2. Move up to (4, 7): 
```
###########
#E  #     #
### ##### #
# #   # # #
##### ### #
# # #  *  #
###########
# # # # # #
###########
# # # # # #
###########
```
3. Move up to (3, 7):
```
###########
#E  #     #
### ##### #
# #   # # #
##### ### #
# # # * # #
###########
# # # # # #
###########
# # # # # #
###########
```
4. Move up to (2, 7):
```
###########
#E  #     #
### ##### #
# #   # # #
##### ### #
# # * # # #
###########
# # # # # #
###########
# # # # # #
###########
```
5. Move left to (2, 6):
```
###########
#E  #     #
### ##### #
# #   # # #
##### ### #
# * # # # #
###########
# # # # # #
###########
# # # # # #
###########
```
6. Move left to (2, 5):
```
###########
#E  #     #
### ##### #
# #   # # #
##### ### #
# * # # # #
###########
# # # # # #
###########
# # # # # #
###########
```
7. Move left to (2, 4):
```
###########
#E  #     #
### ##### #
# #   # # #
##### ### #
* # # # # #
###########
# # # # # #
###########
# # # # # #
###########
```
8. Move down to (3, 4):
```
###########
#E  #     #
### ##### #
# # * # # #
##### ### #
# # # # # #
###########
# # # # # #
###########
# # # # # #
###########
```
9. Move down to (4, 4):
```
###########
#E  #     #
### ##### #
# # * # # #
##### ### #
# # # * # #
###########
# # # # # #
###########
# # # # # #
###########
```
10. Move down to (5, 4):
```
###########
#E  #     #
### ##### #
# # * # # #
##### ### #
# # * # # #
###########
# # # # # #
###########
# # # # # #
###########
```
11. Move right to (5, 5):
```
###########
#E  #     #
### ##### #
# # * # # #
##### ### #
# # * * # #
###########
# # # # # #
###########
# # # # # #
###########
```
12. Move up to (4, 5):
```
###########
#E  #     #
### ##### #
# # * # # #
##### ### #
# # * # # #
###########
# # # # # #
###########
# # # # # #
###########
```
13. Move up to (3, 5):
```
###########
#E  #     #
### ##### #
# # * # # #
##### ### #
# # * # # #
###########
# # # # # #
###########
# # # # # #
###########
```
14. Move up to (2, 5):
```
###########
#E  #     #
### ##### #
# # * # # #
##### ### #
# # * # # #
###########
# # # # # #
###########
# # # # # #
###########
```
15. Move left to (2, 4):
```
###########
#E  #     #
### ##### #
# # * # # #
##### ### #
# # * # # #
###########
# # # # # #
###########
# # # # # #
###########
```
16. Move left to (2, 3):
```
###########
#E  #     #
### ##### #
# # * # # #
##### ### #
# * # # # #
###########
# # # # # #
###########
# # # # # #
###########
```
17. Move down to (3, 3):
```
###########
#E  #     #
### ##### #
# # * # # #
##### ### #
# * # # # #
###########
# # # # # #
###########
# # # # # #
###########
```
18. Move down to (4, 3):
```
###########
#E  #     #
### ##### #
# # * # # #
##### ### #
# * # # # #
###########
# # # # # #
###########
# # # # # #
###########
```
19. Move left to (4, 2):
```
###########
#E  #     #
### ##### #
# # * # # #
##### ### #
# # * # # #
###########
# # # # # #
###########
# # # # # #
###########
```
20. Move up to (3, 2):
```
###########
#E  #     #
### ##### #
# # * # # #
##### ### #
# # * # # #
###########
# # # # # #
###########
# # # # # #
###########
```
21. Move up to (2, 2):
```
###########
#E  #     #
### ##### #
# * * # # #
##### ### #
# # * # # #
###########
# # # # # #
###########
# # # # # #
###########
```
22. Move left to (2, 1):
```
###########
#E  #     #
### ##### #
# * * # # #
##### ### #
# # * # # #
###########
# # # # # #
###########
# # # # # #
###########
```
23. Move up to (1, 1):
```
###########
#E  #     #
### ##### #
# * * # # #
##### ### #
# # * # # #
###########
# # # # # #
###########
# # # # # #
###########
```
24. Move left to (1, 0):
```
###########
# *  #     #
### ##### #
# * * # # #
##### ### #
# # * # # #
###########
# # # # # #
###########
# # # # # #
###########
```
25. Finish the path at E (0, 0).

So the full path is:
- Move Up to (4,7)
- Move Up to (3,7)
- Move Up to (2,7)
- Move Left to (2,6)
- Move Left to (2,5)
- Move Left to (2,4)
- Move Down to (3,4)
- Move Down to (4,4)
- Move Down to (5,4)
- Move Right to (5,5)
- Move Up to (4,5)
- Move Up to (3,5)
- Move Up to (2,5)
- Move Left to (2,4)
- Move Left to (2,3)
- Move Down to (3,3)
- Move Down to (4,3)
- Move Left to (4,2)
- Move Up to (3,2)
- Move Up to (2,2)
- Move Left to (2,1)
- Move Up to (1,1)
- Move Left to (1,0)

In the provided maze, the path from E to S is clear and can be followed step by step according to the strategy I outlined.

HUMAN VERIFICATION: