INPUT:
###########
# #   #   #
### # # # #
#   # # #E#
##### # # #
#   # # # #
# # # # # #
# #S  # # #
# ####### #
#         #
###########

EXPECTED SOLUTION:
###########
# #   #   #
### # # # #
#   # # #E#
##### # #X#
#XXX# # #X#
#X#X# # #X#
#X#S  # #X#
#X#######X#
#XXXXXXXXX#
###########

OUTPUT:
Here's one possible path from S (Start) to E (End) in the maze you provided:

```
###########
# #   #   #
### # # # #
#   # # #E#
##### # # #
#   # # # #
# # # # # #
# #S  # # #
# ####### #
#         #
###########
```

**Path:**

1.  Start at **S**
2.  Right (2 steps)
3.  Up (6 steps)
4.  Right (3 steps) to **E**

**Solution:**

```
###########
# #   #   #
### # # # #
#   # # #E#
##### # # #
#   # # # #
# # # # # #
# #S>>^# # #
# #######^#
#        ^^#
###########
```

HUMAN VERIFICATION: