INPUT:
###########
# # # # # #
##### #####
#S   E# # #
# #########
# #   # # #
# # # #####
#   #   # #
####### ###
#       # #
###########

EXPECTED SOLUTION:
###########
# # # # # #
##### #####
#SXXXE# # #
# #########
# #   # # #
# # # #####
#   #   # #
####### ###
#       # #
###########

OUTPUT:
Here's one possible path from S to E in the maze:

1.  **Start (S)**: (3,1)
2.  Right: (3,2)
3.  Right: (3,3)
4.  Right: (3,4)
5.  **End (E)**: (3,5)



HUMAN VERIFICATION: